%%%%%%%%%%%%%%
%. . . . . % %
%          % %
%. . . . . %G%
%          % %
%. . . . . % %
%          % %
%. . . . . % %
%     S    %E%
%. . . . . % %
%          % %
%. . . . . % %
%            %
%%%%%%%%%%%%%%