%%%%%%%%%%%%%%
%. . . . .   %
%          % %
%. . . . . %G%
%          % %
%. . . . . % %
%          % %
%. . . . . % %
%     S    % %
%. . . . . % %
%          % %
%. . . . . % %
%          %E%
%%%%%%%%%%%%%%